3,3,3,3,3,3,3,3,3,3,3,3,3,3,3,3,3,3,3,3,3,3,3,3,3,3,3,3,3,3,
3,1,1,1,1,1,1,2,2,2,2,2,2,2,2,2,2,2,1,0,0,0,0,1,1,1,1,1,1,3,
3,1,0,0,0,0,0,2,2,2,2,2,2,2,2,2,2,2,1,0,0,0,0,4,4,4,4,4,1,3,
3,1,0,0,0,0,0,2,2,2,2,2,2,2,2,2,0,6,1,0,0,0,0,4,4,4,4,4,1,3,
3,1,0,0,0,0,5,0,0,0,0,0,0,0,0,5,0,0,1,0,0,0,0,4,4,4,4,4,1,3,
3,1,0,1,1,0,0,0,0,0,0,0,0,0,0,0,0,0,0,0,0,0,0,4,4,4,4,4,1,3,
3,1,0,1,1,0,0,0,0,0,0,0,0,0,0,0,0,0,0,0,0,0,0,2,2,2,2,4,1,3,
3,0,0,1,1,0,0,0,0,0,0,0,0,0,0,0,0,0,1,1,0,0,2,2,2,2,2,0,0,3,
3,0,0,1,1,0,0,0,0,0,0,0,0,0,0,0,0,1,1,1,0,2,2,2,2,2,0,0,0,3,
3,0,0,0,0,0,0,0,1,1,1,2,0,0,0,0,0,1,1,1,0,2,2,2,2,0,0,0,0,3,
3,0,0,0,0,0,0,0,0,0,2,2,0,0,0,0,0,0,0,0,0,2,2,2,0,0,0,0,0,3,
3,0,0,0,0,0,0,0,0,0,0,0,0,0,0,0,0,0,0,0,0,2,2,2,0,0,0,0,1,3,
3,1,1,0,0,0,0,0,0,0,0,0,0,0,0,0,0,0,0,0,0,2,2,2,0,0,0,1,1,3,
3,1,0,0,0,2,2,0,0,0,0,4,4,4,4,4,4,4,0,0,0,0,0,0,0,0,0,0,1,3,
3,1,0,0,0,2,2,0,0,0,0,4,4,4,4,4,4,4,0,0,0,0,0,0,0,0,0,1,1,3,
3,1,0,0,0,2,2,0,0,0,0,4,4,4,4,4,4,4,0,0,0,5,0,0,5,0,5,2,1,3,
3,1,0,0,7,0,0,0,0,0,0,4,4,4,4,4,4,4,2,2,2,2,2,2,2,2,2,2,1,3,
3,1,0,0,0,0,0,0,1,2,2,2,2,2,2,2,2,2,2,2,1,1,1,1,2,1,2,2,1,3,
3,1,1,1,1,1,1,1,1,2,2,1,2,2,2,1,2,2,2,1,1,1,1,1,1,1,1,1,1,3,
3,3,3,3,3,3,3,3,3,3,3,3,3,3,3,3,3,3,3,3,3,3,3,3,3,3,3,3,3,3,

